9999999999999999999999999999999999999999999999999999999999999999
9000000000000000000000000000000000000000000000000000000000000459
9000000000000000000000000000000000000000000000000000000000000449
9000000000000000000000000000000000000000000000000000000000000009
9000000000000000000000000000000000000000000000000000000000000009
9000000000000000000000000000000000000000000000000000000000000009
9000000000003000000000000000000000000000000000000300000000000009
9000000000003000000000000000000000000000000000000300000000000009
9000000044443000000000000000000000000000000000000300000000000009
9000000040503000000000000000000000000000000000000300000000000009
9000000044433000000003444300000000000003444300000300000000000009
9000000000003000000003060300000000000003070400000300000000000009
9000000000003000000004433300000000000003334400000300000000000009
9000000000003000000000000000000000000000000000000300004443300009
9000000000003000000000000000000000000000000000000300004050300009
9000000000003000000000000000000000000000000000000300004333300009
9000000000003000000000000000300000000000000000000300000000000009
9000000000003000000000000003000000000000000000000300000000000009
9000000000003000000000000030000000000000000000000300000000000009
9000000000003000000000000000000000000000000000000300000000000009
9000000000003000000000000000000000000000000000000300000000000009
9000000000003000000000000000000000433330000000000300000000000009
9000000000003000000000000000000000407030000000000300000000000009
9000000000003443400000000000000000444440000000000300000000000009
9000000000003060300000000000000000000000000000000300000000000009
9000000000003444300000000000000000000000000000000300000000000009
9000000000003000000000000000000000000000000000000300000000000009
9000000000003000000000000000000000000000000000000300000000000009
9000000000003000000000003333333333300000000000000300000000000009
9000000000003000000000000000000000000000000000000300000000000009
9000000000003000000000000000000000000000000000000300000000000009
9000000000003000000000000000000000000000000000000300000000000009
9000000000003000000000000000000333440000000000000300000000000009
9000000000003000000000000000000305040000000000000300000000000009
9000000000003000000000000000000344430000000000000300000000000009
9000000000003000000000000000000000000000000000000300000000000009
9000000000003000000000000000000000000000000000000300000000000009
9000000000003000000000000000000000000000000000000300000000000009
9000000000003000000000000000000000000000000000000300000000000009
9000000000003000000000000000000000000000000000000300000000000009
9000000000003000000000000000000000000000000000000300000000000009
9000000000000000000000000000000000000000000000000000000000000009
9000000000000000000000000000000000000000000000000000000000000009
9000000000000000000000000000000000000000000000000000000000000009
9440000000000000000000000000000000000000000000000000000000000009
9540000000000000000000000000000000000000000000000000000000000009
9999999999999999999999999999999999999999999999999999999999999999